COD_RIP,COD_REG,COD_PROV,PRO_COM,PRO_COM_T,COMUNE,provincia,elettori maschi,elettori femmine,elettori totale,votanti maschi,votanti femmine,votanti totale,percentuale votanti,numero sezioni,bianche,nulle,contestate
4,16,75,75017,75017,Castri di Lecce,LECCE,1203,1261,2464,884,899,1783,72.36,3,63,41,0
4,16,75,75018,75018,Castrignano de' Greci,LECCE,2176,2217,4393,1126,1143,2269,51.65,5,173,51,0
4,16,75,75019,75019,Castrignano del Capo,LECCE,2863,2946,5809,1328,1294,2622,45.14,6,90,92,0
4,16,75,75020,75020,Cavallino,LECCE,5085,5635,10720,3184,3342,6526,60.88,10,199,204,0
4,16,75,75021,75021,Collepasso,LECCE,2944,3041,5985,1554,1529,3083,51.51,6,148,72,0
4,16,72,72006,72006,Bari,BARI,131882,145363,277245,76238,75841,152079,54.85,346,2408,4284,11
4,16,72,72008,72008,Binetto,BARI,933,919,1852,668,679,1347,72.73,2,57,27,0
4,16,72,72010,72010,Bitetto,BARI,5009,5160,10169,3750,3776,7526,74.01,11,556,252,0
4,16,72,72011,72011,Bitonto,BARI,23140,24238,47378,13397,13016,26413,55.75,51,845,979,0
4,16,72,72012,72012,Bitritto,BARI,5146,5274,10420,2901,2763,5664,54.36,11,120,156,0
4,16,72,72014,72014,Capurso,BARI,6730,7031,13761,4558,4616,9174,66.67,15,601,264,0
4,16,72,72015,72015,Casamassima,BARI,8340,8610,16950,4413,4135,8548,50.43,16,256,188,0
4,16,71,71001,71001,Accadia,FOGGIA,1254,1293,2547,762,844,1606,63.05,3,232,42,0
4,16,72,72016,72016,Cassano delle Murge,BARI,6227,6380,12607,3566,3388,6954,55.16,13,199,249,1
4,16,72,72017,72017,Castellana Grotte,BARI,8796,9408,18204,5365,5398,10763,59.12,18,311,253,0
4,16,72,72018,72018,Cellamare,BARI,2452,2524,4976,1460,1441,2901,58.3,4,75,79,0
4,16,72,72019,72019,Conversano,BARI,11622,11978,23600,8098,7975,16073,68.11,23,1193,370,0
4,16,72,72020,72020,Corato,BARI,21081,22184,43265,14696,15048,29744,68.75,44,2622,652,0
4,16,72,72021,72021,Gioia del Colle,BARI,11536,12291,23827,6724,6692,13416,56.31,25,407,401,0
4,16,71,71002,71002,Alberona,FOGGIA,558,538,1096,240,204,444,40.51,2,18,10,0
4,16,71,71003,71003,Anzano di Puglia,FOGGIA,1177,1155,2332,311,300,611,26.2,2,29,26,0
4,16,71,71004,71004,Apricena,FOGGIA,5879,6044,11923,3416,3368,6784,56.9,15,282,142,0
4,16,71,71005,71005,Ascoli Satriano,FOGGIA,2550,2593,5143,1550,1362,2912,56.62,6,141,126,0
4,16,71,71006,71006,Biccari,FOGGIA,1315,1343,2658,722,677,1399,52.63,3,90,53,4
4,16,72,72022,72022,Giovinazzo,BARI,9115,9647,18762,5226,5207,10433,55.61,23,356,283,0
4,16,72,72023,72023,Gravina in Puglia,BARI,17999,18500,36499,10862,10513,21375,58.56,34,661,673,0
4,16,72,72024,72024,Grumo Appula,BARI,5827,5731,11558,4048,3889,7937,68.67,12,718,271,0
4,16,72,72025,72025,Locorotondo,BARI,6118,6514,12632,4334,4341,8675,68.67,12,807,286,0
4,16,72,72027,72027,Modugno,BARI,15235,16390,31625,11032,11161,22193,70.18,34,1453,595,0
4,16,72,72028,72028,Mola di Bari,BARI,12966,13015,25981,5721,5475,11196,43.09,28,363,234,0
4,16,72,72029,72029,Molfetta,BARI,27303,28924,56227,13478,13658,27136,48.26,60,772,767,2
4,16,71,71007,71007,Bovino,FOGGIA,1968,1883,3851,861,794,1655,42.98,5,89,69,0
4,16,71,71008,71008,Cagnano Varano,FOGGIA,3787,3698,7485,2192,2233,4425,59.12,9,743,197,0
4,16,71,71009,71009,Candela,FOGGIA,1158,1151,2309,813,739,1552,67.22,3,74,59,0
4,16,71,71010,71010,Carapelle,FOGGIA,2293,2404,4697,1399,1293,2692,57.31,5,102,65,0
4,16,71,71011,71011,Carlantino,FOGGIA,662,664,1326,228,230,458,34.54,2,33,11,0
4,16,71,71012,71012,Carpino,FOGGIA,2223,2141,4364,1092,977,2069,47.41,5,51,56,0
4,16,71,71013,71013,Casalnuovo Monterotaro,FOGGIA,807,816,1623,393,337,730,44.98,2,38,14,0
4,16,71,71014,71014,Casalvecchio di Puglia,FOGGIA,959,947,1906,577,564,1141,59.86,2,216,40,0
4,16,72,72030,72030,Monopoli,BARI,21834,22702,44536,11458,10989,22447,50.4,52,630,503,0
4,16,72,72031,72031,Noci,BARI,8408,8942,17350,5160,4974,10134,58.41,17,322,244,0
4,16,72,72032,72032,Noicattaro,BARI,10646,10940,21586,6191,5906,12097,56.04,22,240,241,0
4,16,72,72033,72033,Palo del Colle,BARI,9427,9795,19222,6460,6516,12976,67.51,20,891,387,2
4,16,72,72034,72034,Poggiorsini,BARI,597,591,1188,438,430,868,73.06,2,21,23,0
4,16,72,72035,72035,Polignano a Mare,BARI,8461,8713,17174,4141,3872,8013,46.66,18,244,156,0
4,16,72,72036,72036,Putignano,BARI,12009,12483,24492,7238,7091,14329,58.5,25,574,445,0
4,16,71,71015,71015,Castelluccio dei Sauri,FOGGIA,910,882,1792,509,464,973,54.3,2,54,22,0
4,16,71,71016,71016,Castelluccio Valmaggiore,FOGGIA,844,860,1704,313,336,649,38.09,2,43,14,0
4,16,71,71017,71017,Castelnuovo della Daunia,FOGGIA,813,848,1661,385,344,729,43.89,2,34,27,0
4,16,71,71018,71018,Celenza Valfortore,FOGGIA,869,909,1778,402,358,760,42.74,2,67,18,0
4,16,71,71019,71019,Celle di San Vito,FOGGIA,148,148,296,50,47,97,32.77,1,6,1,0
4,16,72,72037,72037,Rutigliano,BARI,7700,7930,15630,4453,4323,8776,56.15,19,260,157,0
4,16,72,72038,72038,Ruvo di Puglia,BARI,10642,11091,21733,6149,6052,12201,56.14,23,437,353,0
4,16,72,72039,72039,Sammichele di Bari,BARI,3080,3306,6386,1642,1637,3279,51.35,8,92,87,0
4,16,72,72040,72040,Sannicandro di Bari,BARI,5054,4944,9998,2774,2622,5396,53.97,11,119,106,0
4,16,72,72041,72041,Santeramo in Colle,BARI,11882,12046,23928,7229,7145,14374,60.07,23,473,433,0
4,16,72,72043,72043,Terlizzi,BARI,11454,11724,23178,6724,6478,13202,56.96,22,450,588,0
4,16,71,71020,71020,Cerignola,FOGGIA,22227,23544,45771,10452,10068,20520,44.83,50,815,736,1
4,16,71,71021,71021,Chieuti,FOGGIA,940,952,1892,422,409,831,43.92,2,34,22,0
4,16,71,71022,71022,Deliceto,FOGGIA,1775,1829,3604,1050,1004,2054,56.99,5,84,43,0
4,16,71,71023,71023,Faeto,FOGGIA,563,508,1071,159,135,294,27.45,1,14,9,0
4,16,72,72044,72044,Toritto,BARI,3977,3965,7942,2248,2094,4342,54.67,10,102,84,0
4,16,72,72046,72046,Triggiano,BARI,12179,12975,25154,6541,6410,12951,51.49,30,267,334,0
4,16,72,72047,72047,Turi,BARI,6048,6257,12305,3155,2962,6117,49.71,13,152,183,0
4,16,72,72048,72048,Valenzano,BARI,7962,8433,16395,4605,4673,9278,56.59,22,149,227,2
4,16,73,73001,73001,Avetrana,TARANTO,3390,3453,6843,1597,1554,3151,46.05,8,146,103,0
4,16,73,73002,73002,Carosino,TARANTO,2770,2922,5692,1660,1520,3180,55.87,6,135,84,0
4,16,73,73003,73003,Castellaneta,TARANTO,7050,7518,14568,4311,4216,8527,58.53,19,233,288,1
4,16,71,71024,71024,Foggia,FOGGIA,57936,63953,121889,35341,34595,69936,57.38,148,1350,2180,3
4,16,71,71025,71025,Ischitella,FOGGIA,1933,2027,3960,945,883,1828,46.16,4,89,40,0
4,16,71,71026,71026,Isole Tremiti,FOGGIA,239,153,392,138,85,223,56.89,2,1,5,0
4,16,71,71027,71027,Lesina,FOGGIA,2774,2816,5590,1457,1483,2940,52.59,6,609,75,0
4,16,73,73027,73027,Taranto,TARANTO,78396,87417,165813,42282,41575,83857,50.57,191,2231,2712,8
4,16,73,73028,73028,Torricella,TARANTO,1849,1901,3750,1331,1277,2608,69.55,5,72,74,0
4,16,73,73029,73029,Statte,TARANTO,5381,5815,11196,3137,2937,6074,54.25,14,233,198,0
4,16,71,71049,71049,San Nicandro Garganico,FOGGIA,7917,8248,16165,3221,3202,6423,39.73,22,296,231,0
4,16,71,71050,71050,San Paolo di Civitate,FOGGIA,2753,2785,5538,1267,1220,2487,44.91,6,102,66,0
4,16,71,71051,71051,San Severo,FOGGIA,21727,23201,44928,11115,10971,22086,49.16,56,974,819,0
4,16,71,71052,71052,Sant'Agata di Puglia,FOGGIA,945,899,1844,524,451,975,52.87,3,46,36,0
4,16,74,74001,74001,Brindisi,BRINDISI,34593,38697,73290,18605,18959,37564,51.25,80,994,1053,0
4,16,74,74002,74002,Carovigno,BRINDISI,7508,7546,15054,4019,3804,7823,51.97,15,248,245,0
4,16,74,74003,74003,Ceglie Messapica,BRINDISI,9066,9699,18765,5560,5822,11382,60.66,22,933,455,0
4,16,74,74004,74004,Cellino San Marco,BRINDISI,2787,3085,5872,1533,1574,3107,52.91,7,126,115,0
4,16,71,71053,71053,Serracapriola,FOGGIA,2018,2055,4073,1161,1130,2291,56.25,5,293,74,0
4,16,71,71054,71054,Stornara,FOGGIA,1952,1998,3950,1153,1072,2225,56.33,4,105,49,0
4,16,71,71055,71055,Stornarella,FOGGIA,1915,2004,3919,1220,1153,2373,60.55,4,94,38,0
4,16,71,71056,71056,Torremaggiore,FOGGIA,6837,7079,13916,3638,3441,7079,50.87,17,291,255,1
4,16,71,71058,71058,Troia,FOGGIA,2965,3141,6106,1852,1724,3576,58.57,7,136,123,0
4,16,74,74005,74005,Cisternino,BRINDISI,5575,5856,11431,2981,2915,5896,51.58,12,225,187,0
4,16,74,74006,74006,Erchie,BRINDISI,4007,4152,8159,2894,2970,5864,71.87,9,721,207,0
4,16,74,74007,74007,Fasano,BRINDISI,17366,18437,35803,9057,9117,18174,50.76,37,584,418,1
4,16,74,74008,74008,Francavilla Fontana,BRINDISI,14767,15950,30717,8531,8528,17059,55.54,30,660,385,0
4,16,74,74009,74009,Latiano,BRINDISI,6184,6500,12684,4511,4672,9183,72.4,14,1132,251,0
4,16,74,74010,74010,Mesagne,BRINDISI,12030,13174,25204,6344,6437,12781,50.71,27,592,391,0
4,16,71,71059,71059,Vico del Gargano,FOGGIA,3908,3938,7846,1741,1578,3319,42.3,10,98,97,0
4,16,71,71060,71060,Vieste,FOGGIA,6505,6398,12903,3006,2705,5711,44.26,14,243,151,0
4,16,71,71061,71061,Volturara Appula,FOGGIA,412,447,859,115,99,214,24.91,1,19,6,0
4,16,71,71062,71062,Volturino,FOGGIA,741,786,1527,435,420,855,55.99,2,54,24,0
4,16,71,71063,71063,Ordona,FOGGIA,1046,1035,2081,869,855,1724,82.84,2,255,35,0
4,16,71,71064,71064,Zapponeta,FOGGIA,1272,1228,2500,976,877,1853,74.12,2,69,28,0
4,16,74,74011,74011,Oria,BRINDISI,6206,6785,12991,3473,3454,6927,53.32,13,310,245,0
4,16,74,74012,74012,Ostuni,BRINDISI,12981,14226,27207,7152,7086,14238,52.33,31,445,341,0
4,16,74,74013,74013,San Donaci,BRINDISI,2809,3008,5817,1541,1456,2997,51.52,7,215,137,0
4,16,74,74014,74014,San Michele Salentino,BRINDISI,2864,2877,5741,1559,1503,3062,53.34,6,201,80,0
4,16,74,74015,74015,San Pancrazio Salentino,BRINDISI,4472,4621,9093,2476,2428,4904,53.93,10,246,218,0
4,16,74,74016,74016,San Pietro Vernotico,BRINDISI,5879,6548,12427,3089,3175,6264,50.41,16,283,193,0
4,16,72,72001,72001,Acquaviva delle Fonti,BARI,8609,9284,17893,5705,5658,11363,63.51,20,334,222,0
4,16,72,72002,72002,Adelfia,BARI,7718,7927,15645,4354,4246,8600,54.97,16,172,175,0
4,16,72,72003,72003,Alberobello,BARI,4864,5048,9912,2730,2607,5337,53.84,9,258,142,0
4,16,72,72004,72004,Altamura,BARI,27635,29069,56704,16788,16530,33318,58.76,60,1134,914,0
4,16,74,74017,74017,San Vito dei Normanni,BRINDISI,8949,9523,18472,5542,6001,11543,62.49,19,945,323,0
4,16,74,74018,74018,Torchiarolo,BRINDISI,2326,2426,4752,1716,1784,3500,73.65,5,547,198,0
4,16,74,74019,74019,Torre Santa Susanna,BRINDISI,4640,4906,9546,2679,2654,5333,55.87,11,313,268,0
4,16,74,74020,74020,Villa Castelli,BRINDISI,4016,4019,8035,2424,2359,4783,59.53,7,213,180,0
4,16,75,75002,75002,Alessano,LECCE,3100,3287,6387,1568,1560,3128,48.97,7,169,77,4
4,16,75,75003,75003,Alezio,LECCE,2788,2922,5710,1475,1522,2997,52.49,5,89,72,0
4,16,75,75004,75004,Alliste,LECCE,3184,3383,6567,1401,1330,2731,41.59,7,130,75,0
4,16,75,75005,75005,Andrano,LECCE,2065,2213,4278,1308,1305,2613,61.08,5,111,64,0
4,16,75,75006,75006,Aradeo,LECCE,4594,4836,9430,2127,2250,4377,46.42,9,224,81,0
4,16,75,75007,75007,Arnesano,LECCE,1692,1759,3451,1271,1277,2548,73.83,4,263,54,0
4,16,75,75008,75008,Bagnolo del Salento,LECCE,731,799,1530,568,569,1137,74.31,2,44,28,0
4,16,73,73004,73004,Crispiano,TARANTO,5811,6002,11813,3400,3220,6620,56.04,13,284,186,0
4,16,73,73005,73005,Faggiano,TARANTO,1436,1545,2981,894,786,1680,56.36,4,81,38,0
4,16,73,73006,73006,Fragagnano,TARANTO,2353,2491,4844,1348,1365,2713,56.01,5,113,91,0
4,16,73,73007,73007,Ginosa,TARANTO,9598,9789,19387,5438,5052,10490,54.11,22,369,322,0
4,16,73,73008,73008,Grottaglie,TARANTO,13051,14076,27127,7056,6643,13699,50.5,27,536,450,32
4,16,71,71028,71028,Lucera,FOGGIA,13397,14425,27822,8954,9008,17962,64.56,33,1353,604,0
4,16,71,71029,71029,Manfredonia,FOGGIA,24134,24705,48839,13484,12587,26071,53.38,59,1000,819,0
4,16,71,71031,71031,Mattinata,FOGGIA,3047,2971,6018,1922,1974,3896,64.74,6,431,101,0
4,16,71,71032,71032,Monteleone di Puglia,FOGGIA,793,804,1597,378,362,740,46.34,3,93,26,0
4,16,73,73009,73009,Laterza,TARANTO,6380,6656,13036,5025,4982,10007,76.76,14,625,335,0
4,16,73,73010,73010,Leporano,TARANTO,3492,3486,6978,2054,1947,4001,57.34,6,112,123,0
4,16,73,73011,73011,Lizzano,TARANTO,4425,4570,8995,2550,2485,5035,55.98,9,232,133,0
4,16,73,73012,73012,Manduria,TARANTO,13012,13848,26860,9424,9612,19036,70.87,30,2162,1018,0
4,16,73,73013,73013,Martina Franca,TARANTO,20247,21679,41926,12381,12053,24434,58.28,44,746,692,1
4,16,71,71033,71033,Monte Sant'Angelo,FOGGIA,5701,5854,11555,3301,3070,6371,55.14,17,181,176,0
4,16,71,71034,71034,Motta Montecorvino,FOGGIA,343,361,704,189,189,378,53.69,1,28,5,0
4,16,71,71035,71035,Orsara di Puglia,FOGGIA,1578,1568,3146,761,702,1463,46.5,4,102,65,0
4,16,71,71036,71036,Orta Nova,FOGGIA,6726,6957,13683,3631,3354,6985,51.05,16,258,181,0
4,16,71,71037,71037,Panni,FOGGIA,696,724,1420,265,268,533,37.54,2,28,19,0
4,16,71,71038,71038,Peschici,FOGGIA,2122,2100,4222,1099,973,2072,49.08,4,66,74,0
4,16,73,73014,73014,Maruggio,TARANTO,2376,2444,4820,1590,1416,3006,62.37,5,127,79,0
4,16,73,73015,73015,Massafra,TARANTO,13020,13754,26774,7889,7320,15209,56.81,26,507,424,2
4,16,73,73016,73016,Monteiasi,TARANTO,2273,2409,4682,1449,1323,2772,59.21,5,116,76,0
4,16,73,73017,73017,Montemesola,TARANTO,1610,1707,3317,1195,1225,2420,72.96,4,175,49,0
4,16,73,73018,73018,Monteparano,TARANTO,1037,1068,2105,624,586,1210,57.48,2,61,46,0
4,16,73,73019,73019,Mottola,TARANTO,6787,7126,13913,4393,4174,8567,61.58,18,306,212,0
4,16,73,73020,73020,Palagianello,TARANTO,3171,3364,6535,1948,1802,3750,57.38,6,170,130,0
4,16,73,73021,73021,Palagiano,TARANTO,6477,6682,13159,4052,3839,7891,59.97,14,282,226,0
4,16,71,71039,71039,Pietramontecorvino,FOGGIA,1247,1346,2593,731,665,1396,53.84,3,67,29,0
4,16,71,71040,71040,Poggio Imperiale,FOGGIA,1145,1147,2292,598,539,1137,49.61,3,70,39,0
4,16,71,71041,71041,Rignano Garganico,FOGGIA,910,963,1873,528,500,1028,54.89,2,33,20,0
4,16,71,71042,71042,Rocchetta Sant'Antonio,FOGGIA,861,897,1758,652,629,1281,72.87,2,149,17,0
4,16,71,71043,71043,Rodi Garganico,FOGGIA,1684,1638,3322,838,780,1618,48.71,4,81,41,0
4,16,71,71044,71044,Roseto Valfortore,FOGGIA,1068,1122,2190,229,217,446,20.37,2,20,11,0
4,16,73,73022,73022,Pulsano,TARANTO,4809,5016,9825,2917,2736,5653,57.54,9,203,175,0
4,16,73,73023,73023,Roccaforzata,TARANTO,772,777,1549,502,458,960,61.98,2,44,30,0
4,16,73,73024,73024,San Giorgio Ionico,TARANTO,6089,6550,12639,3405,3304,6709,53.08,13,203,203,0
4,16,73,73025,73025,San Marzano di San Giuseppe,TARANTO,3866,3973,7839,2273,2163,4436,56.59,8,240,124,0
4,16,73,73026,73026,Sava,TARANTO,7094,7524,14618,3824,3650,7474,51.13,15,292,240,0
4,16,71,71046,71046,San Giovanni Rotondo,FOGGIA,11688,12128,23816,6836,6630,13466,56.54,26,489,446,0
4,16,71,71047,71047,San Marco in Lamis,FOGGIA,6894,7248,14142,3524,3545,7069,49.99,18,345,343,0
4,16,71,71048,71048,San Marco la Catola,FOGGIA,990,991,1981,241,216,457,23.07,2,46,25,0
4,16,75,75009,75009,Botrugno,LECCE,1390,1490,2880,779,789,1568,54.44,3,63,36,0
4,16,75,75010,75010,Calimera,LECCE,2957,3275,6232,2304,2589,4893,78.51,7,555,113,0
4,16,75,75011,75011,Campi Salentina,LECCE,4324,4807,9131,2723,2794,5517,60.42,10,205,144,0
4,16,75,75012,75012,Cannole,LECCE,817,799,1616,525,475,1000,61.88,2,40,32,0
4,16,75,75013,75013,Caprarica di Lecce,LECCE,1023,1138,2161,695,688,1383,64,3,56,29,0
4,16,75,75014,75014,Carmiano,LECCE,5121,5442,10563,3198,3199,6397,60.56,10,214,150,0
4,16,75,75015,75015,Carpignano Salentino,LECCE,1832,1788,3620,1130,1062,2192,60.55,5,126,52,0
4,16,75,75016,75016,Casarano,LECCE,9080,9811,18891,5713,6026,11739,62.14,23,923,401,1
4,16,75,75031,75031,Gallipoli,LECCE,10032,10229,20261,4938,5000,9938,49.05,24,325,296,0
4,16,75,75032,75032,Giuggianello,LECCE,533,544,1077,371,358,729,67.69,1,40,9,0
4,16,75,75033,75033,Giurdignano,LECCE,863,907,1770,550,531,1081,61.07,2,55,18,0
4,16,75,75034,75034,Guagnano,LECCE,2598,2754,5352,1485,1430,2915,54.47,6,168,87,0
4,16,75,75035,75035,Lecce,LECCE,36071,42028,78099,21339,23308,44647,57.17,103,1014,1154,1
4,16,75,75036,75036,Lequile,LECCE,3486,3797,7283,2163,2218,4381,60.15,7,127,130,0
4,16,75,75037,75037,Leverano,LECCE,5976,6210,12186,3380,3320,6700,54.98,12,304,150,0
4,16,75,75038,75038,Lizzanello,LECCE,4801,5089,9890,2983,3058,6041,61.08,9,231,176,0
4,16,75,75039,75039,Maglie,LECCE,6003,6879,12882,4451,4847,9298,72.18,17,478,216,0
4,16,75,75040,75040,Martano,LECCE,4394,4635,9029,2955,3149,6104,67.6,10,758,160,0
4,16,75,75041,75041,Martignano,LECCE,740,745,1485,515,519,1034,69.63,2,37,33,0
4,16,75,75042,75042,Matino,LECCE,5488,5729,11217,2600,2577,5177,46.15,12,236,186,0
4,16,75,75043,75043,Melendugno,LECCE,4456,4591,9047,2585,2552,5137,56.78,8,255,204,0
4,16,75,75044,75044,Melissano,LECCE,3236,3339,6575,1575,1439,3014,45.84,7,163,81,0
4,16,75,75045,75045,Melpignano,LECCE,1216,1240,2456,823,848,1671,68.04,3,107,16,0
4,16,75,75046,75046,Miggiano,LECCE,1530,1691,3221,920,915,1835,56.97,3,116,40,0
4,16,75,75047,75047,Minervino di Lecce,LECCE,1709,1841,3550,1060,1044,2104,59.27,4,72,42,0
4,16,75,75048,75048,Monteroni di Lecce,LECCE,5571,6120,11691,3993,4321,8314,71.11,11,801,264,0
4,16,75,75049,75049,Montesano Salentino,LECCE,1137,1190,2327,761,747,1508,64.8,3,88,59,0
4,16,75,75050,75050,Morciano di Leuca,LECCE,1940,2011,3951,785,804,1589,40.22,4,65,25,0
4,16,75,75051,75051,Muro Leccese,LECCE,2274,2436,4710,1369,1392,2761,58.62,5,115,82,0
4,16,75,75052,75052,Nardo',LECCE,14281,15305,29586,8082,8788,16870,57.02,33,461,351,0
4,16,75,75053,75053,Neviano,LECCE,2581,2763,5344,1693,1880,3573,66.86,5,526,121,0
4,16,75,75054,75054,Nociglia,LECCE,1061,1166,2227,607,639,1246,55.95,3,55,28,0
4,16,75,75055,75055,Novoli,LECCE,3378,3757,7135,2056,2160,4216,59.09,7,156,79,0
4,16,75,75056,75056,Ortelle,LECCE,1047,1104,2151,712,700,1412,65.64,3,37,26,0
4,16,75,75057,75057,Otranto,LECCE,2513,2729,5242,1552,1579,3131,59.73,6,97,73,0
4,16,75,75058,75058,Palmariggi,LECCE,701,730,1431,444,411,855,59.75,2,49,24,0
4,16,75,75059,75059,Parabita,LECCE,4424,4692,9116,2423,2470,4893,53.67,10,167,123,0
4,16,75,75060,75060,PatÃ¹,,,,,,,,,,,,
4,16,75,75061,75061,Poggiardo,LECCE,2572,2852,5424,1606,1643,3249,59.9,6,130,63,0
4,16,75,75063,75063,Racale,LECCE,4859,5089,9948,3224,3327,6551,65.85,9,588,231,0
4,16,75,75064,75064,Ruffano,LECCE,4453,4702,9155,2008,1981,3989,43.57,10,194,165,0
4,16,75,75065,75065,Salice Salentino,LECCE,3642,3887,7529,2092,2017,4109,54.58,7,204,119,0
4,16,75,75066,75066,Salve,LECCE,2733,2858,5591,1160,1183,2343,41.91,5,132,65,0
4,16,75,75067,75067,Sanarica,LECCE,702,731,1433,400,424,824,57.5,2,18,11,0
4,16,75,75068,75068,San Cesario di Lecce,LECCE,3253,3592,6845,2048,2133,4181,61.08,7,133,88,0
4,16,75,75069,75069,San Donato di Lecce,LECCE,2274,2619,4893,1605,1761,3366,68.79,5,146,86,0
4,16,75,75070,75070,Sannicola,LECCE,2956,3122,6078,1421,1430,2851,46.91,7,143,70,0
4,16,75,75071,75071,San Pietro in Lama,LECCE,1466,1692,3158,1141,1274,2415,76.47,4,336,126,0
4,16,75,75072,75072,Santa Cesarea Terme,LECCE,1237,1393,2630,840,856,1696,64.49,4,52,24,0
4,16,75,75073,75073,Scorrano,LECCE,3326,3394,6720,2007,2020,4027,59.93,8,135,127,0
4,16,75,75074,75074,Secli',LECCE,895,950,1845,503,554,1057,57.29,2,54,29,0
4,16,75,75075,75075,Sogliano Cavour,LECCE,1845,1888,3733,1373,1428,2801,75.03,4,314,98,0
4,16,75,75076,75076,Soleto,LECCE,2268,2470,4738,1429,1424,2853,60.22,5,122,63,0
4,16,75,75077,75077,Specchia,LECCE,2341,2421,4762,1216,1132,2348,49.31,5,98,71,0
4,16,75,75078,75078,Spongano,LECCE,1600,1753,3353,1004,1029,2033,60.63,4,94,36,0
4,16,75,75079,75079,Squinzano,LECCE,6227,6867,13094,3815,4086,7901,60.34,18,269,159,3
4,16,75,75080,75080,Sternatia,LECCE,936,1048,1984,690,732,1422,71.67,3,49,33,0
4,16,75,75081,75081,Supersano,LECCE,2023,2077,4100,989,955,1944,47.41,4,109,47,0
4,16,75,75082,75082,Surano,LECCE,776,861,1637,465,460,925,56.51,2,52,23,0
4,16,75,75083,75083,Surbo,LECCE,5890,6461,12351,4176,4540,8716,70.57,13,716,340,0
4,16,75,75084,75084,Taurisano,LECCE,6264,6322,12586,2529,2530,5059,40.2,14,199,117,0
4,16,75,75085,75085,Taviano,LECCE,5100,5514,10614,2719,2706,5425,51.11,11,259,147,0
4,16,75,75086,75086,Tiggiano,LECCE,1297,1308,2605,840,841,1681,64.53,3,53,18,0
4,16,75,75087,75087,Trepuzzi,LECCE,6025,6532,12557,3748,3988,7736,61.61,13,315,225,0
4,16,75,75088,75088,Tricase,LECCE,7791,8352,16143,5369,5740,11109,68.82,21,993,300,0
4,16,75,75089,75089,Tuglie,LECCE,3011,3065,6076,1529,1561,3090,50.86,6,89,74,0
4,16,75,75090,75090,Ugento,LECCE,6486,6578,13064,2676,2603,5279,40.41,14,248,162,0
4,16,75,75091,75091,Uggiano la Chiesa,LECCE,1954,2181,4135,1457,1614,3071,74.27,4,392,92,0
4,16,75,75092,75092,Veglie,LECCE,5923,6289,12212,4266,4477,8743,71.59,12,988,277,0
4,16,75,75093,75093,Vernole,LECCE,3054,3233,6287,1969,1986,3955,62.91,9,135,147,0
4,16,75,75094,75094,Zollino,LECCE,947,1016,1963,624,676,1300,66.23,2,62,29,0
4,16,75,75095,75095,San Cassiano,LECCE,897,948,1845,618,575,1193,64.66,2,52,25,0
4,16,75,75096,75096,Castro,LECCE,1029,1157,2186,708,766,1474,67.43,3,72,26,0
4,16,75,75097,75097,Porto Cesareo,LECCE,2757,2715,5472,2015,2014,4029,73.63,4,423,72,0
4,16,75,75098,75098,Presicce-Acquarica,LECCE,5505,5754,11259,3057,3235,6292,55.88,12,840,209,0
4,16,75,75022,75022,Copertino,LECCE,10524,11045,21569,5795,5938,11733,54.4,26,457,296,0
4,16,75,75023,75023,Corigliano d'Otranto,LECCE,2718,3012,5730,1825,2100,3925,68.5,5,349,112,0
4,16,75,75024,75024,Corsano,LECCE,2561,2504,5065,1389,1341,2730,53.9,5,122,61,0
4,16,75,75025,75025,Cursi,LECCE,1840,1911,3751,1221,1172,2393,63.8,4,91,55,0
4,16,75,75026,75026,Cutrofiano,LECCE,3972,4410,8382,2761,2964,5725,68.3,9,613,135,0
4,16,75,75027,75027,Diso,LECCE,1333,1456,2789,838,859,1697,60.85,3,96,33,0
4,16,75,75028,75028,Gagliano del Capo,LECCE,2799,2842,5641,1574,1655,3229,57.24,5,442,85,0
4,16,75,75029,75029,Galatina,LECCE,11348,12468,23816,6440,6605,13045,54.77,28,508,283,0
4,16,75,75030,75030,Galatone,LECCE,7246,7662,14908,4055,4133,8188,54.92,15,305,227,0
4,16,110,110001,110001,Andria,BARLETTA-ANDRIA-TRANI,40837,42303,83140,27373,27758,55131,66.31,110,3461,1881,0
4,16,110,110002,110002,Barletta,BARLETTA-ANDRIA-TRANI,39404,40424,79828,23498,22468,45966,57.58,100,1459,1172,0
4,16,110,110003,110003,Bisceglie,BARLETTA-ANDRIA-TRANI,23823,24566,48389,12121,11802,23923,49.44,51,876,844,0
4,16,110,110004,110004,Canosa di Puglia,BARLETTA-ANDRIA-TRANI,12833,13312,26145,6428,6292,12720,48.65,32,482,581,0
4,16,110,110005,110005,Margherita di Savoia,BARLETTA-ANDRIA-TRANI,4934,5141,10075,2898,2726,5624,55.82,13,131,115,0
4,16,110,110006,110006,Minervino Murge,BARLETTA-ANDRIA-TRANI,4241,4319,8560,2426,2306,4732,55.28,12,199,215,0
4,16,110,110007,110007,San Ferdinando di Puglia,BARLETTA-ANDRIA-TRANI,5570,5651,11221,3399,3161,6560,58.46,14,263,154,0
4,16,110,110008,110008,Spinazzola,BARLETTA-ANDRIA-TRANI,2739,2895,5634,1670,1604,3274,58.11,7,154,133,0
4,16,110,110009,110009,Trani,BARLETTA-ANDRIA-TRANI,24043,24853,48896,16751,16659,33410,68.33,54,2988,1164,16
4,16,110,110010,110010,Trinitapoli,BARLETTA-ANDRIA-TRANI,5478,5844,11322,4196,4311,8507,75.14,14,930,201,0
